XXXXXXXXXXXXXXXXXXXXX
X             X     X
X X X X X XXXXX XXXXX
X X X X X           X
XXX X XXX XXX XXX X X
X   X   X   X   X X X
X X X X XXXXXXXXXXX X
X X X X         X   X
X X X XXXXX XXXXXXXXX
  X X   X X       X X
XXXXXXX X X XXXXX X X
X       X       X X X
X XXX X X XXXXX X X X
X X   X X X   X X   X
X XXXXX X X XXX XXXXX
X X     X     X     X
X XXXXXXXXX X X XXX X
X X   X     X X   X X
XXXXX XXX X XXXXXXX X
X         X   X      
XXXXXXXXXXXXXXXXXXXXX
